35 65
34 63 0 63
XXXXXXXXXXXXXXXXXXXXXXXXXXXXXXXXXXXXXXXXXXXXXXXXXXXXXXXXXXXXXXX X
X                     XX    XX                           X      X
X XXXXXXXXX XXXXXXXXX XX XX XX XXXXXXXXXXXXXXXXXXXXXXXXX X XXXXXX
X X XXXXX X X       X XX XX XX X   XXXX    XXXX   XXXXXX X X    X
X X       X X XX XX X XX XX    X X X  X      X  X      X   X XX X
X X XXXXX X XXX XXX X    XXXXXXX X   XX XXXX XX XXXXXX XXXXX X  X
X X     X           XXXXXXXX   X XXXXXX X  X XX X   XX       X XX
X XXXXXXXXXXXXXXXXXXXXXXXXXX X X      X XX X XX X X  XXXXXXXXX XX
X    XX         XXXXXXX   XX X X XXXX X XX X    X XX X   X   X XX
XX X XX X XX XX X     X X  X X     XX X XX XXXXXX XX X X X X X  X
XX X XX X XX XX X XXXXX XXXX XXX XXX         X    XX X X X X XX X
XX X XX X XX    X            XX  XXX XXXXXXX X XXXXX X X X X XX X
XX X    X XXXXX XXXXXXX XXXXXXX XX   X       X X     X X X X XX X
XX XXXXXX X   X       X X   X   XX XXX XXXXXXX X XXXXX X X X  X X
XX        X X XXXXXXX X X X X XXXX X   X       X       X   XX   X
XXXXXXXXXXX X       X X   X   XXXX X XX   XXXXXXXXXXXXXXXXXXXXX X
X    X      XXXXXXX X XXXXXXXXXXXX X    XX          X           X
X  XXXX  XXX    XXX X       X      XXXXXX  XXXXXXXX X X XXXXXXXXX
XXX   XXXX   XXXXXX XXXXXXX X XX XXX      X         X X XXX     X
 XX XXX XX X      X       X X XX X   XXXXXX XXXXXXXXX X   X  XX X
X    XX XX XXXXXX XXXXXXXXX X XX XXX XX             X XXX  X XX X
X XX       XXXXXX XXXXXXXXX X XX     XXXXXXXX XXXXX X    X X XX X
X XXXXXXXXXX                X XX XXXXX   X    XXXXX XXXX X X XX X
X XX       X XXXXXXXXXXXXX XX XX X   X X X X XX        X X X  X X
X XX XXXXX X XXXXXX     XX XX XX X X X X X X XX XXXXXXXX X XXXX X
X XX XX XX X X      XXX    XX XXXX X   X   X XX X        X   XX X
X XX    XX X X XXXXXXXXXXXXXX XXXX XXXXXXXXXXXX X XXXXXXXXXX    X
X XXXXXXXX X                  X                 X X   XX   XXXXXX
X          XXXXXXXXXX XXXXXXXXXXXXXXXXXXXXXXXXXXX X X XX X X   XX
XXXXXXXXXXXX     X    X      XX           X       X X    X X X XX
XX       XXXXXXX X XXXXXXXXX    XXXXXXXXX X XXXXXXX XXXXXX X X XX
X  XXXXX         X           XXX        X X   XXXXX XX       X  X
XXXX XXX XXXXXXXXX XXXXXXXXXX  X X XXXXXX XXX       XXXXXXXXXXX X
X                  XXXXXXXXXXX   X       XXXXX XX X          XX X
XXXXXXXXXXXXXXXXXXXXXXXXXXXXXXXXXXXXXXXXXXXXXXXXXXXXXXXXXXXXXXX X
